id	nicknames
Aaden	Aaden
Aaliyah	Aaliyah
Aarav	Aarav
Aaron	Aaron
Abbey	Abbey
Abbie	Abbie
Abbigail	Abby
Abby	Abby
Abdiel	Abdiel
Abdullah	Abdul
Abel	Abel
Abigail	Abby
Abraham	Abe
Abram	Abe
Abrielle	Abby
Abril	Abril
Ace	Ace
Ada	Ada
Adalyn	Ada
Adalynn	Ada
Adam	Ad
Adan	Ad
Addilyn	Addy, Ad
Addison	Addy, Ad
Addisyn	Addy, Ad
Addyson	Addy, Ad
Adelaide	Addy, Ad
Adele	Addy, Ad
Adelina	Addy, Ad
Adeline	Addy, Ad
Adelyn	Addy, Ad
Adelynn	Addy, Ad
Aden	Addy, Ad
Aditya	Addy, Ad
Adonis	Addy, Ad
Adrian	Addy, Ad
Adriana	Addy, Ad
Adrianna	Addy, Ad
Adriel	Adriel
Adrien	Adrien
Adrienne	Adrienne
Adyson	Addy, Ad
Agustin	Gus
Ahmad	Ahmad
Ahmed	Ahmed
Aidan	Aidan
Aiden	Aiden
Aidyn	Aidyn
Aileen	Aileen
Aimee	Aimee
Ainsley	Ainsley
Aisha	Aisha
Aiyana	Aiyana
Akira	Akira
Alaina	Alaina
Alan	Alan, Al
Alana	Alana, Lana
Alani	Alani, Lani
Alanna	Alanna, Lanna
Alannah	Alannah, Lannah
Alaya	Alaya
Alayah	Alayah
Alayna	Alayna
Albert	Al, Bert
Alberto	Al, Bert
Alden	Al
Aldo	Al
Aleah	Aleah
Alec	Alec
Aleena	Leena
Aleigha	Aleigha
Alejandra	Alejandra
Alejandro	Alejandro
Alena	Alena
Alessandra	Alessandra
Alessandro	Alessandro
Alex	Alex
Alexa	Alexa
Alexander	Alex
Alexandra	Alex
Alexandria	Alex
Alexia	Alex
Alexis	Alex
Alexzander	Alex
Alfonso	Alf
Alfred	Alf, Fred
Alfredo	Alf, Fred
Ali	Ali
Alia	Ali
Aliana	Ali
Alianna	Ali
Alice	Alice
Alicia	Alicia
Alijah	Alijah
Alina	Alina
Alisha	Alisha
Alison	Alison
Alissa	Alissa
Alisson	Alisson
Alivia	Liv
Aliya	Aliya
Aliyah	Aliyah
Aliza	Aliza
Allan	Allan
Allen	Allen
Allie	Allie
Allison	Allison
Ally	Ally
Allyson	Allyson
Alma	Alma
Alondra	Alondra
Alonso	Alonso
Alonzo	Alonzo
Alvaro	Alvaro
Alvin	Alvin
Alyson	Alyson
Alyssa	Alyssa
Alyvia	Alyvia
Amalia	Amalia
Amanda	Amanda
Amani	Amani
Amara	Amara
Amare	Amare
Amari	Amari
Amaya	Amaya
Amber	Amber
Amelia	Amelia
Amelie	Amelie
America	America
Amina	Amina
Amir	Amir
Amira	Amira
Amirah	Amirah
Amiya	Amiya
Amiyah	Amiyah
Amos	Amos
Amy	Amy
Amya	Amya
Ana	Ana
Anabel	Anna
Anabella	Anna, Bella
Anabelle	Anna, Bella
Anahi	Anahi
Analia	Analia
Anastasia	Annie
Anaya	Anaya
Anders	Anders
Anderson	Anderson
Andre	Andre
Andrea	Andrea
Andres	Andres
Andrew	Andy
Andy	Andy
Angel	Angel
Angela	Angela
Angelica	Angelica
Angelina	Angel
Angeline	Angel
Angelique	Angel
Angelo	Angelo
Angie	Angie
Anika	Annie
Aniya	Annie
Aniyah	Annie
Ann	Annie
Anna	Annie
Annabel	Annie
Annabell	Annie
Annabella	Annie
Annabelle	Annie
Annalise	Anna
Anne	Anne
Annie	Annie
Annika	Annika
Ansley	Ansley
Anthony	Tony
Antoine	Antoine
Antonio	Tony
Anya	Anya
April	April
Arabella	Arabella
Araceli	Araceli
Archer	Archer
Arely	Arely
Ari	Ari
Aria	Aria
Arian	Ari
Ariana	Ari
Arianna	Ari
Ariel	Ari
Ariella	Ariella
Arielle	Arielle
Arjun	Arj
Arlo	Arlo
Armando	Ari
Armani	Armani
Arnav	Arnav
Aron	Aron
Arthur	Art
Arturo	Art
Arya	Arya
Aryan	Aryan
Aryana	Aryana
Aryanna	Aryanna
Asa	Asa
Asher	Asher
Ashley	Ash
Ashlyn	Ash
Ashlynn	Ash
Ashton	Ash
Ashtyn	Ash
Asia	Asia
Aspen	Aspen
Athena	Athena
Atticus	Atticus
Aubree	Aubree
Aubrey	Aubrey
Aubri	Aubri
Aubrianna	Aubri
Aubrie	Aubrie
Audrey	Audrey
Audriana	Audri
Audrianna	Audri
Audrina	Audri
August	Gus
Augustus	Gus
Aurelia	Ella, Ellie
Aurora	Rory
Austin	Austin
Autumn	Autumn
Ava	Ava
Avah	Avah
Averi	Averi
Averie	Averie
Avery	Avery
Aviana	Aviana
Avianna	Ava
Axel	Ax
Ayaan	Ayaan
Ayana	Ayana
Ayanna	Ayanna
Aydan	Aydan
Ayden	Ayden
Aydin	Aydin
Ayla	Ayla
Ayleen	Ayleen
Aylin	Aylin
Azaria	Azaria
Bailee	Bailee
Bailey	Bailey
Barbara	Barb
Barrett	Barrett
Baylee	Baylee
Beatrice	Bea
Beau	Beau
Beckett	Beckett
Beckham	Beckham
Belen	Belen
Bella	Bella
Ben	Ben
Benjamin	Ben, Benny
Bennett	Ben, Benny
Benson	Ben, Benny
Bentlee	Ben, Benny
Bentley	Ben, Benny
Bently	Bently
Benton	Benton
Bethany	Beth
Bianca	Bianca
Billy	Bill
Blaine	Blaine
Blair	Blair
Blaise	Blaise
Blake	Blake
Blakely	Blakely
Blaze	Blaze
Bo	Bo
Bobby	Bobby, Bob
Bodhi	Bodhi
Boston	Boston
Bowen	Bowen
Braden	Brad
Bradley	Brad
Brady	Brady
Bradyn	Brad
Braeden	Braeden
Braelyn	Lyn
Braelynn	Lynn
Braiden	Braiden
Branden	Branden
Brandon	Brandon
Branson	Branson
Brantley	Brantley
Braxton	Brax
Brayan	Brayan
Brayden	Brayden
Braydon	Braydon
Braylee	Braylee
Braylen	Braylen
Braylin	Braylin
Braylon	Braylon
Breanna	Breanna
Brecken	Brecken
Bree	Bree
Brenda	Brenda
Brendan	Brendan
Brenden	Brenden
Brendon	Brendon
Brenna	Brenna
Brennan	Brennan
Brennen	Brennen
Brent	Brent
Brenton	Brenton
Brett	Brett
Bria	Bria
Brian	Brian
Briana	Briana
Brianna	Brianna
Brice	Brice
Bridger	Bridger
Bridget	Bridget
Briella	Briella
Brielle	Brielle
Briley	Briley
Brinley	Brinley
Brisa	Brisa
Bristol	Bristol
Britney	Brit
Brittany	Brit
Brock	Brock
Broderick	Rick
Brodie	Brodie
Brody	Brody
Brogan	Brogan
Bronson	Bronson
Brooke	Brooke
Brooklyn	Brook, Lyn
Brooklynn	Brook, Lynn
Brooks	Brooks
Bruce	Brucie
Bruno	Bruno
Bryan	Bryan
Bryanna	Bryanna
Bryant	Bryant
Bryce	Bryce
Brycen	Brycen
Brylee	Brylee
Bryleigh	Bryleigh
Bryn	Bryn
Brynlee	Brynlee
Brynn	Brynn
Brysen	Brysen
Bryson	Bryson
Byron	Byron
Cade	Cade
Caden	Caden
Cadence	Cadence
Cael	Cael
Caiden	Caiden
Cailyn	Cailyn
Cain	Cain
Caitlin	Cait
Caitlyn	Cait
Cale	Cale
Caleb	Caleb
Cali	Cali
Callan	Callan
Callen	Callen
Callie	Callie
Callum	Callum
Calvin	Cal
Cambria	Cambria
Camden	Cam
Camdyn	Cam
Cameron	Cam
Camila	Camila
Camilla	Camilla
Camille	Camille
Camilo	Camilo
Campbell	Cam
Camren	Cam
Camron	Cam
Camryn	Cam
Cannon	Cannon
Cara	Cara
Carissa	Carissa
Carl	Carl
Carla	Carla
Carlee	Carlee
Carleigh	Carleigh
Carley	Carley
Carlie	Carlie
Carlos	Carlos
Carly	Carly
Carmelo	Carlo, Carl
Carmen	Carmen
Carolina	Carolina
Caroline	Caroline
Carolyn	Carolyn
Carson	Carson
Carter	Carter
Case	Case
Casen	Casen
Casey	Casey
Cash	Cash
Cason	Cason
Cassandra	Cassandra
Cassidy	Cassidy
Cassius	Cassius
Catalina	Catalina
Catherine	Catherine
Cayden	Cayden
Caydence	Caydence
Caylee	Caylee
Cayson	Cayson
Cecelia	Cecelia
Cecilia	Cecilia
Cedric	Cedric
Celeste	Celeste
Celia	Celia
Cesar	Cesar
Chace	Chace
Chad	Chad
Chaim	Chaim
Chana	Chana
Chance	Chance
Chandler	Chandler
Chanel	Chanel
Channing	Channing
Charity	Charity
Charlee	Charlie, Chuck
Charleigh	Charlie, Chuck
Charles	Charlie, Chuck
Charley	Charlie, Chuck
Charli	Charlie, Chuck
Charlie	Charlie, Chuck
Charlotte	Lottie
Chase	Chase
Chaya	Chaya
Chelsea	Chelsea
Cherish	Cherish
Cheyanne	Cheyanne
Cheyenne	Cheyenne
Chloe	Chloe
Chris	Chris
Christian	Chris
Christina	Christie, Xina
Christine	Christie, Xina
Christopher	Chris
Ciara	Ciara
Cindy	Cindy
Claire	Claire
Clara	Clara
Clare	Clare
Clarissa	Clarissa
Clark	Clark
Claudia	Claudia
Clay	Clay
Clayton	Clay
Clinton	Clint
Cody	Cody
Coen	Coen
Cohen	Cohen
Colby	Colby
Cole	Cole
Coleman	Cole
Colin	Colin
Collin	Collin
Colt	Colt
Colten	Colten
Colton	Colton
Conner	Conner
Connor	Connor
Conor	Conor
Conrad	Conrad
Cooper	Coop
Cora	Cora
Corban	Corban
Corbin	Corbin
Corey	Corey
Corinne	Corinne
Cortez	Cortez
Cory	Cory
Courtney	Court
Craig	Craig
Crew	Crew
Cristian	Cristian
Cristiano	Cristiano
Cristina	Cristina
Cristopher	Cristopher
Crosby	Crosby
Cruz	Cruz
Crystal	Crystal
Cullen	Cullen
Curtis	Curtis
Cynthia	Cyn
Cyrus	Cyrus
Dahlia	Dahlia
Daisy	Daisy
Dakota	Dakota
Dalia	Dalia
Dallas	Dallas
Dalton	Dalton
Damari	Damari
Damarion	Damarion
Damaris	Damaris
Damian	Damian
Damien	Damien
Damion	Damion
Damon	Damon
Dana	Dana
Dane	Dane
Dangelo	Dangelo
Danica	Danica
Daniel	Daniel
Daniela	Daniela
Daniella	Dani
Danielle	Dani
Danika	Dani
Danna	Danna
Danny	Danny
Dante	Dante
Daphne	Daphne
Darian	Darian
Darien	Darien
Dario	Dario
Darius	Darius
Darnell	Darnell
Darrell	Darrell
Darren	Darren
Darryl	Darryl
Darwin	Darwin
Davian	Davian
David	David
Davin	Davin
Davion	Davion
Davis	Davis
Davon	Davon
Dawson	Dawson
Dax	Dax
Daxton	Daxton
Dayana	Dayana
Dayton	Dayton
Deacon	Deacon
Dean	Dean
Deandre	Deandre
Deangelo	Deangelo
Deanna	Deanna
Deborah	Deb, Debbie, Bee
Declan	Declan
Deegan	Deegan
Delaney	Delaney
Delilah	Delilah
Demarcus	Demarcus
Demetrius	Demetri
Demi	Demi
Denise	Denise
Dennis	Dennis
Deon	Deon
Derek	Derek
Derick	Derick
Derrick	Derrick
Deshawn	Deshawn
Desiree	Desiree
Desmond	Des
Destinee	Destinee
Destiny	Destiny
Devan	Devan
Deven	Deven
Devin	Devin
Devon	Devon
Dexter	Dex
Diamond	Diamond
Diana	Diana
Diego	Diego
Dillon	Dillon
Dimitri	Dimitri
Dixie	Dixie
Diya	Diya
Dominic	Dom
Dominick	Dom, Nick
Dominik	Dom, Nick
Dominique	Dom
Donald	Don
Donovan	Don
Donte	Donte
Dorian	Dorian
Dorothy	Dottie
Douglas	Douglas
Drake	Drake
Draven	Draven
Drew	Drew
Dulce	Dulce
Duncan	Duncan
Dustin	Dustin
Dwayne	Dwayne
Dylan	Dylan
Ean	Ean
Easton	East
Eddie	Ed, Eddie
Eden	Eden
Edgar	Ed, Eddie
Edison	Ed, Eddie
Edith	Edie
Eduardo	Ed, Eddie
Edward	Ted, Ed, Eddie
Edwin	Ed, Eddie
Efrain	Efrain
Eileen	Eileen
Elaina	Elaina
Elaine	Elaine
Eleanor	Nora
Elena	Elena
Eli	Eli
Elian	Elian
Eliana	Eliana
Elianna	Elianna
Elias	Elias
Elijah	Elijah
Elin	Elin
Elisa	Elisa
Elisabeth	Liz, Lizzie, Beth
Elise	Elise
Eliseo	Eliseo
Elisha	Elisha
Eliza	Eliza
Elizabeth	Liz, Lizzie, Beth
Ella	Ella
Elle	Elle
Ellen	Ellen
Elliana	Elliana
Ellie	Ellie
Elliot	Elliot
Elliott	Elliott
Ellis	Ellis
Eloise	Eloise
Elsa	Elsa
Elsie	Elsie
Elvis	Elvis
Elyse	Elyse
Emanuel	Emanuel
Ember	Ember
Emelia	Emelia
Emely	Emely
Emerson	Emerson
Emersyn	Emersyn
Emery	Emery
Emilee	Emilee
Emilia	Emilia
Emiliano	Emiliano
Emilie	Emilie
Emilio	Emilio
Emily	Em
Emma	Em
Emmalee	Em
Emmalyn	Em
Emmanuel	Emmanuel
Emmett	Emmett
Emmitt	Emmitt
Emmy	Emmy
Enoch	Enoch
Enrique	Enrique
Enzo	Enzo
Eric	Eric
Erica	Erica
Erick	Erick
Erik	Erik
Erika	Erika
Erin	Erin
Ernest	Ernie
Ernesto	Ernie
Esme	Esme
Esmeralda	Emma, Esme
Esperanza	Esperanza
Esteban	Esteban
Esther	Esther
Estrella	Estrella
Ethan	Ethan
Ethen	Ethen
Eugene	Eugene
Eva	Eva
Evan	Evan
Evangeline	Ev, Angie
Eve	Eve
Evelyn	Eve
Evelynn	Eve
Everett	Everett
Evie	Evie
Ezekiel	Zeke
Ezequiel	Zeke
Ezra	Ezra
Fabian	Fabian
Faith	Faith
Farrah	Farrah
Fatima	Fatima
Felicity	Felicity
Felipe	Felipe
Felix	Felix
Fernanda	Fernanda
Fernando	Nando
Finley	Fin
Finn	Finn
Finnegan	Fin
Fiona	Fiona
Fisher	Fisher
Fletcher	Fletch
Flynn	Flynn
Frances	Frances
Francesca	Francesca
Francis	Francis
Francisco	Francisco
Franco	Franco
Frank	Franky
Frankie	Frankie
Franklin	Frank
Freddy	Fred
Frederick	Fred
Gabriel	Gabriel
Gabriela	Gabby
Gabriella	Gabby
Gabrielle	Gabby
Gael	Gael
Gage	Gage
Gaige	Gaige
Galilea	Galilea
Garrett	Garrett
Gary	Gary
Gauge	Gauge
Gavin	Gavin
Gavyn	Gavyn
Gemma	Gemma
Genesis	Genesis
Genesis	Gia
Genevieve	Genevieve
George	George
Georgia	Georgia
Gerald	Gerald
Geraldine	Geraldine
Gerardo	Gerry, Jerry
Gertrude	Gertie, Trudy
Gia	Gia
Giada	Giada
Giana	Giana
Giancarlo	Carlo
Gianna	Gianna
Gianni	Gianni
Gibson	Gibson
Gideon	Gideon
Gilbert	Gil, Beto
Gilberto	Gil, Beto
Giovani	Giovani
Giovanna	Giovanna
Giovanni	Gio
Giovanny	Gio
Giselle	Giselle
Gisselle	Gisselle
Giuliana	Giuliana
Gloria	Gloria
Grace	Grace
Gracelyn	Gracelyn
Gracelynn	Gracelynn
Gracie	Gracie
Grady	Grady
Graham	Graham
Grant	Grant
Graysen	Graysen
Grayson	Grayson
Gregory	Greg
Greta	Greta
Greyson	Grey
Griffin	Griff
Guadalupe	Lupe
Guillermo	Guille, Memo
Gunnar	Gunnar
Gunner	Gunner
Gustavo	Gus
Gwendolyn	Wendy
Gwyneth	Wendy
Hadassah	Hadassah
Hadley	Hadley
Haiden	Haiden
Hailee	Hailee
Hailey	Hailey
Haleigh	Haleigh
Haley	Haley
Halle	Halle
Hallie	Hallie
Hamza	Hamza
Hana	Hana
Hank	Hank
Hanna	Hanna
Hannah	Hannah
Harley	Harley
Harlow	Harlow
Harmony	Harmony
Harold	Harold
Harper	Harper
Harrison	Harrison
Harry	Harry, Har
Harvey	Harvey
Hassan	Hassan
Hattie	Hattie
Haven	Haven
Hayden	Hayden
Hayes	Hayes
Haylee	Haylee
Hayleigh	Hayleigh
Hayley	Hayley
Haylie	Haylie
Hazel	Hazel
Heath	Heath
Heather	Heather
Heaven	Heaven
Hector	Hector
Heidi	Heidi
Helen	Helen
Helena	Helena
Hendrix	Hendrix
Henry	Henry
Hezekiah	Zeke
Holden	Holden
Holly	Holly
Hope	Hope
Houston	Houston
Howard	Howard
Hudson	Hudson
Hugh	Hugh
Hugo	Hugo
Hunter	Hunter
Ian	Ian
Ibrahim	Ibrahim
Ignacio	Ignacio
Iker	Iker
Iliana	Iliana
Imani	Imani
Ingrid	Inga
Irene	Irene
Iris	Iris
Irvin	Irvin
Isaac	Isaac
Isabel	Isabel
Isabela	Isabela
Isabell	Isabell
Isabella	Isabella
Isabelle	Isabelle
Isai	Isai
Isaiah	Isaiah
Isaias	Isaias
Ishaan	Ishaan
Isiah	Isiah
Isis	Isis
Isla	Isla
Ismael	Ismael
Israel	Israel
Issac	Issac
Itzel	Itzel
Ivan	Ivan
Ivanna	Ivanna
Ivy	Ivy
Izabella	Izabella
Izabelle	Izabelle
Izaiah	Izaiah
Izayah	Izayah
Jabari	Jabari
Jace	Jace
Jacey	Jacey
Jack	Jack
Jackson	Jack
Jacob	Jake
Jacoby	Jake
Jacqueline	Jacqueline
Jada	Jada
Jade	Jade
Jaden	Jaden
Jadiel	Jadiel
Jadon	Jadon
Jadyn	Jadyn
Jaeden	Jaeden
Jaelyn	Jaelyn
Jaelynn	Jaelynn
Jagger	Jagger
Jaida	Jaida
Jaiden	Jaiden
Jaidyn	Jaidyn
Jaime	Jaime
Jair	Jair
Jairo	Jairo
Jakayla	Jakayla
Jake	Jake
Jakob	Jakob
Jakobe	Jakobe
Jalen	Jalen
Jaliyah	Jaliyah
Jamal	Jamal
Jamar	Jamar
Jamari	Jamari
Jamarion	Jamarion
James	James
Jameson	Jameson
Jamie	Jamie
Jamir	Jamir
Jamison	Jamison
Janae	Janae
Jane	Jane
Janelle	Janelle
Janessa	Janessa
Janet	Janet
Janiya	Janiya
Janiyah	Janiyah
Jaqueline	Jaqueline
Jared	Jared
Jaron	Jaron
Jase	Jase
Jasiah	Jasiah
Jasmin	Jasmin
Jasmine	Jasmine
Jason	Jason
Jasper	Jasper
Javier	Javier
Javion	Javion
Javon	Javon
Jax	Jax
Jaxen	Jax
Jaxon	Jax
Jaxson	Jax
Jaxton	Jax
Jay	Jay
Jayce	Jayce
Jaycee	Jaycee
Jaycob	Jay
Jayda	Jay
Jaydan	Jay
Jayde	Jay
Jayden	Jay
Jaydin	Jay
Jaydon	Jay
Jayla	Jayla
Jaylah	Jaylah
Jaylee	Jaylee
Jayleen	Jayleen
Jaylen	Jaylen
Jaylene	Jaylene
Jaylin	Jaylin
Jaylon	Jaylon
Jaylyn	Jaylyn
Jaylynn	Jaylynn
Jayson	Jayson
Jazlyn	Jazlyn
Jazlynn	Jazlynn
Jazmin	Jazmin
Jazmine	Jazmine
Jazmyn	Jazmyn
Jean	Jean
Jedidiah	Jed
Jefferson	Jeff
Jeffery	Jeff
Jeffrey	Jeff
Jemma	Jemma
Jenna	Jenny, Jen
Jennifer	Jenny, Jen
Jenny	Jenny, Jen
Jensen	Jensen
Jeramiah	Jeramiah
Jeremiah	Jeremiah
Jeremy	Jeremy
Jerimiah	Jerimiah
Jermaine	Jermaine
Jerome	Jerome
Jerry	Jerry
Jesse	Jesse
Jessica	Jess
Jessie	Jessie
Jesus	Jesus
Jett	Jett
Jewel	Jewel
Jillian	Jillian
Jimena	Jimena
Jimmy	Jimmy
Joanna	Joanna
Joaquin	Joaquin
Jocelyn	Jocelyn
Jocelynn	Jocelynn
Joe	Joe
Joel	Joel
Joey	Joey
Johan	Johan
Johann	Johann
Johanna	Johanna
John	John
Johnathan	John
Johnathon	John
Johnny	Johnny
Jolene	Jolene
Jolie	Jolie
Jon	Jon
Jonah	Jonah
Jonas	Jonas
Jonathan	Jon
Jonathon	Jon
Jordan	Jordan
Jorden	Jorden
Jordyn	Jordyn
Jordynn	Jordynn
Jorge	Jorge
Jose	Jose
Joselyn	Joselyn
Joseph	Joseph
Josephine	Josephine
Joshua	Joshua
Josiah	Josiah
Josie	Josie
Joslyn	Joslyn
Josue	Josue
Journee	Journee
Journey	Journey
Jovani	Jovani
Jovanni	Jovanni
Joy	Joy
Joyce	Joyce
Joziah	Joziah
Juan	Juan
Judah	Judah
Jude	Jude
Judith	Judith
Julia	Julia
Julian	Julian
Juliana	Juliana
Julianna	Julianna
Julianne	Julianne
Julie	Julie
Julien	Julie
Juliet	Julie
Julieta	Julie
Juliette	Julie
Julio	Julio
Julissa	Julie
Julius	Julius
June	June
Junior	Junior
Juniper	Juniper
Justice	Justice
Justin	Justin
Justus	Justus
Kade	Kade
Kaden	Kaden
Kadence	Kadence
Kaeden	Kaeden
Kael	Kael
Kaelyn	Kaelyn
Kaelynn	Kaelynn
Kai	Kai
Kaia	Kaia
Kaiden	Kaiden
Kailee	Kailee
Kailey	Kailey
Kailyn	Kailyn
Kailynn	Kailynn
Kairi	Kairi
Kaitlin	Kaitlin
Kaitlyn	Kaitlyn
Kaitlynn	Kaitlynn
Kaiya	Kaiya
Kale	Kale
Kaleb	Kaleb
Kaleigh	Kaleigh
Kali	Kali
Kaliyah	Kaliyah
Kallie	Kallie
Kamari	Kamari
Kamden	Kamden
Kameron	Kameron
Kamila	Kamila
Kamille	Kamille
Kamren	Kamren
Kamron	Kam
Kamryn	Kamryn
Kane	Kane
Kara	Kara
Kareem	Kareem
Karen	Karen
Karina	Karina
Karis	Karis
Karissa	Karissa
Karla	Karla
Karlee	Karlee
Karlie	Karlie
Karly	Karly
Karma	Karma
Karson	Karson
Karsyn	Karsyn
Karter	Karter
Kasen	Kasen
Kasey	Kasey
Kash	Kash
Kason	Kason
Kassandra	Kassandra
Kassidy	Kass
Kate	Kate
Katelyn	Kate
Katelynn	Kate
Katherine	Kate, Kathy, Kat
Kathleen	Kate, Kathy, Kat
Kathryn	Kate, Kathy, Kat
Katie	Kate, Kathy, Kat
Kaya	Kaya
Kayden	Kayden
Kaydence	Kaydence
Kayla	Kayla
Kaylee	Kaylee
Kayleigh	Kayleigh
Kaylen	Kaylen
Kaylie	Kaylie
Kaylin	Kaylin
Kaylyn	Kaylyn
Kaylynn	Kaylynn
Kayson	Kayson
Keagan	Keagan
Keaton	Keaton
Keegan	Keegan
Keenan	Keenan
Keira	Keira
Keith	Keith
Kellan	Kellan
Kellen	Kellen
Kelly	Kelly
Kelsey	Kelsey
Kelsie	Kelsie
Kelvin	Kelvin
Kendal	Kendal
Kendall	Kendall
Kendra	Kendra
Kendrick	Ken
Kendyl	Kendyl
Kenley	Kenley
Kenna	Kenna
Kennedi	Kennedi
Kennedy	Kennedy
Kenneth	Ken
Kenny	Kenny
Kensley	Kensley
Kenya	Kenya
Kenzie	Kenzie
Keon	Keon
Kevin	Kevin
Keyla	Keyla
Keyon	Keyon
Khalil	Khalil
Khloe	Khloe
Kian	Kian
Kiana	Kiana
Kiara	Kiara
Kiera	Kiera
Kieran	Kieran
Kiersten	Kiersten
Kiley	Kiley
Killian	Killian
Kimber	Kimber
Kimberly	Kim
Kimora	Kim
King	King
Kingsley	King
Kingston	King
Kinley	Kinley
Kinsey	Kinsey
Kinsley	Kinsley
Kira	Kira
Kirsten	Kirsten
Knox	Knox
Kobe	Kobe
Kody	Kody
Kohen	Kohen
Kolby	Kolby
Kole	Kole
Kolten	Kolten
Kolton	Kolton
Konner	Konner
Konnor	Konnor
Korbin	Korbin
Kourtney	Kourtney
Krish	Krish
Kristen	Kristen
Kristian	Kristian
Kristina	Kristina
Kristopher	Kristopher
Krystal	Krystal
Kyan	Kyan
Kyla	Kyla
Kylah	Kylah
Kylan	Kylan
Kyle	Kyle
Kylee	Kylee
Kyleigh	Kyleigh
Kyler	Kyler
Kylie	Kylie
Kymani	Kymani
Kyndal	Kyndal
Kyndall	Kyndall
Kynlee	Kynlee
Kyra	Kyra
Kyron	Kyron
Kyson	Kyson
Lacey	Lacey
Laila	Laila
Lailah	Lailah
Lainey	Lainey
Lamar	Lamar
Lana	Lana
Lance	Lance
Landen	Landen
Landon	Landon
Landry	Landry
Landyn	Landyn
Lane	Lane
Laney	Laney
Lara	Lara
Larissa	Larissa
Larry	Larry
Lathan	Lathan
Laura	Laura
Laurel	Laurel
Lauren	Lauren
Lauryn	Lauryn
Lawrence	Larry
Lawson	Lawson
Layla	Layla
Laylah	Laylah
Layne	Layne
Layton	Layton
Lea	Lea
Leah	Leah
Leandro	Leandro
Leanna	Leanna
Lee	Lee
Legend	Legend
Leia	Leia
Leigha	Leigha
Leighton	Leighton
Leila	Leila
Leilani	Leilani
Leland	Leland
Lena	Lena
Lennon	Lennon
Lennox	Lennox
Leo	Leo
Leon	Leon
Leona	Leona
Leonard	Lenny, Len, Leo
Leonardo	Lenny, Len, Leo
Leonel	Lenny, Len, Leo
Leonidas	Lenny, Len, Leo
Leslie	Leslie
Lesly	Lesly
Levi	Levi
Lewis	Lewis
Lexi	Lex
Lexie	Lex
Leyla	Leyla
Lia	Lia
Liam	Liam
Liana	Liana
Libby	Lib
Liberty	Lib
Lila	Lila
Lilah	Lilah
Lilia	Lilia
Lilian	Lily
Liliana	Lily
Lilianna	Lily
Lilith	Lily
Lillian	Lily
Lilliana	Lily
Lillianna	Lily
Lillie	Lily
Lilly	Lilly
Lily	Lily
Lilyana	Lilyana
Lilyanna	Lilyanna
Lina	Lina
Lincoln	Lincoln
Linda	Linda
Lindsay	Lindsay
Lindsey	Lindsey
Lionel	Lionel
Lisa	Lisa
Liv	Liv
Livia	Livia
Lizbeth	Lizbeth
Logan	Logan
Lola	Lola
London	London
Londyn	Londyn
Lorelai	Lorelai
Lorelei	Lorelei
Lorenzo	Enzo
Louis	Louis
Luca	Luca
Lucas	Luke
Lucia	Lucia
Lucian	Lucian
Luciana	Luciana
Luciano	Luciano
Lucille	Lucille
Lucy	Lucy
Luis	Luis
Luka	Luka
Lukas	Lukas
Luke	Luke
Luna	Luna
Luz	Luz
Lydia	Lydia
Lyla	Lyla
Lylah	Lylah
Lyric	Lyric
Macey	Macey
Maci	Maci
Macie	Macie
Mackenzie	Mackenzie
Macy	Macy
Madalyn	Maddie
Madalynn	Maddie
Madden	Madden
Maddison	Maddie
Maddox	Maddox
Madeleine	Madeleine
Madeline	Maddie
Madelyn	Madelyn
Madelynn	Maddie
Madilyn	Maddie
Madilynn	Maddie
Madison	Maddie
Madisyn	Maddie
Madyson	Maddie
Mae	Mae
Maeve	Maeve
Maggie	Maggie
Maia	Maia
Major	Major
Makai	Makai
Makayla	Makayla
Makenna	Makenna
Makenzie	Makenzie
Makhi	Makhi
Maksim	Maksim
Malachi	Malachi
Malakai	Malakai
Malaki	Malaki
Malaya	Malaya
Malaysia	Malaysia
Malcolm	Malcolm
Maleah	Maleah
Malia	Malia
Maliah	Maliah
Malik	Mal
Maliyah	Maliyah
Mallory	Mallory
Manuel	Manny
Mara	Mara
Marc	Marc
Marcel	Marcel
Marcelo	Marcelo
Marco	Marco
Marcos	Marcos
Marcus	Marcus
Margaret	Marge, Peg, Peggy
Margot	Maggie
Maria	Maria
Mariah	Mariah
Mariam	Mariam
Mariana	Mariana
Marianna	Marianna
Mariano	Mariano
Marie	Marie
Marigold	Maggie
Marilyn	Marilyn
Marina	Marina
Mario	Mario
Marisa	Marisa
Marisol	Marisol
Marissa	Marissa
Maritza	Maritza
Mariyah	Mariyah
Mark	Mark
Markus	Markus
Marlee	Marlee
Marlene	Marlene
Marley	Marley
Marlon	Marlon
Marquis	Marquis
Marshall	Marsh
Martha	Martha
Martin	Marty
Marvin	Marv
Mary	Polly
Maryam	Maryam
Masen	Masen
Mason	Mason
Mateo	Matt
Mathew	Matt
Mathias	Mathias
Matias	Matias
Matilda	Matilda
Matteo	Matt
Matthew	Matt
Matthias	Matt
Mattie	Mattie
Maurice	Maurice
Mauricio	Mauricio
Maverick	Maverick
Max	Max
Maxim	Max
Maximilian	Max
Maximiliano	Max
Maximo	Max
Maximus	Max
Maxton	Max
Maxwell	Max
Maxx	Maxx
Maya	Maya
Mayson	Mayson
Mckayla	Mckayla
Mckenna	Mckenna
Mckenzie	Kenzie
Mckinley	Mckinley
Meadow	Meadow
Megan	Megan
Meghan	Meghan
Mekhi	Mekhi
Melanie	Melanie
Melany	Melany
Melina	Melina
Melissa	Melissa
Melody	Melody
Melvin	Melvin
Memphis	Memphis
Mercedes	Mercy, Sadie
Meredith	Meredith
Messiah	Messiah
Mia	Mia
Miah	Miah
Micah	Micah
Michael	Mike
Michaela	Michaela
Micheal	Mike
Michelle	Michelle
Miguel	Mike
Mikaela	Mikaela
Mikayla	Mikayla
Mike	Mike
Mila	Mila
Milagros	Milagros
Milan	Milan
Milana	Milana
Milania	Milania
Miles	Miles
Miley	Miley
Miller	Miller
Millie	Millie
Milo	Milo
Mina	Mina
Mira	Mira
Miracle	Miracle
Miranda	Miranda
Miriam	Miriam
Misael	Misael
Mitchell	Mitchell
Miya	Miya
Mohamed	Md
Mohammad	Md
Mohammed	Md
Moises	Moises
Mollie	Mollie
Molly	Molly
Monica	Monica
Morgan	Morgan
Moriah	Moriah
Moses	Moses
Moshe	Moshe
Muhammad	Md
Mustafa	Mustafa
Mya	Mya
Myah	Myah
Myla	Myla
Myles	Myles
Myra	Myra
Nadia	Nadia
Nahla	Nahla
Nancy	Nancy
Naomi	Naomi
Nash	Nash
Nasir	Nas
Natalee	Nat
Natalia	Nat
Natalie	Nat
Nataly	Nat
Natalya	Nat
Natasha	Nat
Nathalie	Nat
Nathaly	Nat
Nathan	Nat
Nathanael	Nathan
Nathaniel	Nathan
Nayeli	Nayeli
Nehemiah	Nehemiah
Neil	Neil
Nelson	Nelson
Nevaeh	Nevaeh
Neveah	Neveah
Nia	Nia
Nicholas	Nick
Nickolas	Nick
Nico	Nico
Nicolas	Nick
Nicole	Nicki
Niko	Niko
Nikolai	Nikolai
Nikolas	Nikolas
Nina	Nina
Nixon	Nixon
Noah	Noah
Noe	Noe
Noel	Noel
Noelle	Noelle
Noemi	Noemi
Nola	Nola
Nolan	Nolan
Nora	Nora
Norah	Norah
Nova	Nova
Nyla	Nyla
Nylah	Nylah
Odin	Odin
Olive	Liv
Oliver	Oliver
Olivia	Liv
Omar	Omar
Omari	Omari
Orion	Orion
Orlando	Orlando
Oscar	Oscar
Osvaldo	Osvaldo
Otto	Otto
Owen	Owen
Pablo	Pablo
Paige	Paige
Paisley	Paisley
Paityn	Paityn
Paloma	Paloma
Pamela	Pamela
Paola	Paola
Paris	Paris
Parker	Parker
Patience	Pat, Patty
Patricia	Pat, Patty
Patrick	Pat, Patty
Paul	Paul
Paula	Paula
Paulina	Paulina
Paxton	Paxton
Payten	Payten
Payton	Payton
Pearl	Pearl
Pedro	Pedro
Penelope	Pen
Perla	Perla
Peter	Pete
Peyton	Peyton
Philip	Phil
Phillip	Phil
Phoebe	Phoebe
Phoenix	Phoenix
Pierce	Pierce
Pierre	Pierre
Piper	Piper
Porter	Porter
Presley	Presley
Preston	Preston
Prince	Prince
Princess	Princess
Princeton	Princeton
Priscilla	Priscilla
Prudence	Prue, Prudy
Quentin	Quentin
Quincy	Quincy
Quinn	Quinn
Quinten	Quinten
Quintin	Quintin
Quinton	Quinton
Rachael	Rachael
Rachel	Rachel
Raegan	Raegan
Raelyn	Raelyn
Raelynn	Raelynn
Rafael	Rafael
Raiden	Raiden
Raina	Raina
Ralph	Ralph
Ramiro	Ramiro
Ramon	Ramon
Randall	Randy
Randy	Randy
Raphael	Raphael
Raquel	Raquel
Rashad	Rashad
Raul	Raul
Raven	Raven
Ray	Ray
Rayan	Rayan
Rayden	Rayden
Raylan	Raylan
Raymond	Ray
Rayna	Rayna
Rayne	Rayne
Reagan	Reagan
Rebecca	Becca
Rebekah	Bekah
Reece	Reece
Reed	Reed
Reese	Reese
Regan	Regan
Regina	Regina
Reginald	Reggie
Reid	Reid
Remington	Remy
Remy	Remy
Renata	Renata
Rene	Rene
Renee	Renee
Reuben	Reuben
Rex	Rex
Rey	Rey
Reyna	Reyna
Rhett	Rhett
Rhys	Rhys
Ricardo	Ricardo
Richard	Rick
Ricky	Ricky
Rihanna	Rihanna
Riley	Riley
River	River
Rivka	Rivka
Riya	Riya
Robert	Bob, Boddy, Rob, Robbie, Robin
Roberto	Bob, Boddy, Rob, Robbie, Robin
Rocco	Rocco
Roderick	Rod
Rodney	Rod
Rodolfo	Rod
Rodrigo	Rod
Rogelio	Rog
Roger	Rog
Rohan	Rohan
Roland	Rollie
Rolando	Rolando
Roman	Roman
Romeo	Romeo
Ronald	Ron
Ronan	Ron
Ronin	Ronin
Ronnie	Ronnie
Rory	Rory
Rosa	Rosie
Rosalie	Rosie
Rose	Rosie
Roselyn	Rosie
Rosemary	Rosie
Ross	Ross
Rowan	Rowan
Rowen	Rowen
Roy	Roy
Royce	Royce
Ruben	Ruben
Ruby	Ruby
Rudy	Rudy
Russell	Russ
Ruth	Ruthie
Ryan	Ryan
Ryann	Ryann
Ryder	Ryder
Ryker	Ryker
Rylan	Rylan
Ryland	Ryland
Rylee	Rylee
Ryleigh	Ryleigh
Rylen	Rylen
Rylie	Rylie
Saanvi	Saanvi
Sabrina	Sabrina
Sadie	Sadie
Sage	Sage
Saige	Saige
Salma	Salma
Salvador	Sal
Salvatore	Sal
Sam	Sam
Samantha	Samantha
Samara	Samara
Samir	Sam
Samiya	Sam
Samiyah	Sam
Samson	Sam
Samuel	Sam, Sammie
Sanaa	Sanaa
Sandra	Sandra
Saniya	Saniya
Saniyah	Saniyah
Santiago	Santiago
Santino	Tino
Santos	Santos
Sara	Sara
Sarah	Sally
Sarahi	Sarahi
Sarai	Sarai
Sariah	Sariah
Sariyah	Sariyah
Sasha	Sasha
Saul	Saul
Savanna	Savanna
Savannah	Savannah
Sawyer	Sawyer
Scarlet	Scarlet
Scarlett	Scarlett
Scott	Scottie
Seamus	Seamus
Sean	Sean
Sebastian	Seb
Selah	Selah
Selena	Selena
Semaj	Semaj
Serena	Serena
Serenity	Serenity
Sergio	Sergio
Seth	Seth
Shane	Shane
Shania	Shania
Shaniya	Shaniya
Shannon	Shannon
Sharon	Sharon
Shaun	Shaun
Shawn	Shawn
Shayla	Shayla
Shelby	Shelby
Sherlyn	Sherlyn
Shiloh	Shiloh
Sidney	Sidney
Siena	Siena
Sienna	Sienna
Sierra	Sierra
Silas	Silas
Simon	Simon
Simone	Simone
Sincere	Sincere
Sky	Sky
Skye	Skye
Skyla	Skyla
Skylar	Sky
Skyler	Sky
Sloan	Sloan
Sloane	Sloane
Sofia	Sofia
Solomon	Solomon
Sonia	Sonia
Sonny	Sonny
Sophia	Sophie
Sophie	Sophie
Sophronia	Fran
Soren	Soren
Spencer	Spencer
Stacy	Stacy
Stanley	Stan
Stefan	Stefan
Stella	Stella
Stephanie	Stephanie
Stephen	Stephen
Sterling	Sterling
Steve	Steve
Steven	Steven
Sue	Sue, Susie
Sullivan	Sullivan
Summer	Summer
Susan	Sue, Susie
Sydney	Sydney
Sylas	Sylas
Sylvia	Sylvia
Tabitha	Tabitha
Talia	Talia
Taliyah	Taliyah
Talon	Talon
Tamia	Tamia
Tanner	Tanner
Tara	Tara
Taraji	Taraji
Taryn	Taryn
Tate	Tate
Tatiana	Tatiana
Tatum	Tatum
Taylor	Taylor
Teagan	Teagan
Tegan	Tegan
Temperance	Temperance
Tenley	Tenley
Teresa	Teresa
Terrance	Terrance
Terrell	Terrell
Terrence	Terry
Terry	Terry
Tess	Tess
Tessa	Tessa
Thaddeus	Thaddeus
Thalia	Thalia
Theo	Theo
Theodore	Ted
Thomas	Tom
Tia	Tia
Tiana	Tiana
Tianna	Tianna
Tiffany	Tiffany
Timothy	Timothy
Tinley	Tinley
Titus	Titus
Tobias	Toby
Toby	Toby
Todd	Todd
Tomas	Tom
Tommy	Tommy
Tony	Tony
Tori	Tori
Trace	Trace
Travis	Trav
Trent	Trent
Trenton	Trenton
Trevon	Trevon
Trevor	Trevor
Trey	Trey
Trinity	Trinity
Tripp	Tripp
Tristan	Tristan
Tristen	Tristen
Tristian	Tristian
Tristin	Tristin
Triston	Triston
Troy	Troy
Trystan	Trystan
Tucker	Tucker
Turner	Turner
Ty	Ty
Tyler	Ty
Tyree	Ty
Tyrell	Ty
Tyrese	Ty
Tyrone	Ty
Tyson	Ty
Ulises	Ulises
Uriah	Uriah
Uriel	Uriel
Urijah	Urijah
Valentin	Valentin
Valentina	Tina
Valentino	Tino
Valeria	Val
Valerie	Val
Van	Van
Vance	Vance
Vanessa	Vanessa
Vaughn	Vaughn
Vera	Vera
Veronica	Veronica
Vicente	Vic
Victor	Vic
Victoria	Vicky, Vic
Vihaan	Vihaan
Vincent	Vinny
Vincenzo	Vinny
Violet	Lettie
Virginia	Virginia
Vivian	Viv, Vivi
Viviana	Viv, Vivi
Vivienne	Viv, Vivi
Wade	Wade
Walker	Walker
Walter	Walter
Warren	Warren
Waylon	Waylon
Wayne	Wayne
Wendy	Wendy
Wesley	Wesley
Westin	Westy
Weston	Weston
Whitney	Whitney
Will	Will
Willa	Willa
William	Bill, Will, Willie
Willie	Willie
Willow	Willow
Wilson	Wilson
Winnifred	Winnie
Winston	Win
Wyatt	Wyatt
Xander	Xander
Xavi	Xavi
Xavier	Xavier
Ximena	Ximena
Xzavier	Xzavier
Yadiel	Yadiel
Yahir	Yahir
Yamilet	Yamilet
Yamileth	Yamileth
Yandel	Yandel
Yareli	Yareli
Yaretzi	Yaretzi
Yaritza	Yaritza
Yasmin	Yas
Yazmin	Yaz
Yehuda	Yehuda
Yesenia	Yesenia
Yosef	Yosef
Yoselin	Yoselin
Yuliana	Yulia
Yusuf	Yusuf
Zachariah	Zach, Zak
Zachary	Zach, Zak
Zachery	Zach, Zak
Zackary	Zach, Zak
Zackery	Zach, Zak
Zaiden	Zaiden
Zain	Zain
Zaire	Zaire
Zander	Zander
Zane	Zane
Zaniyah	Zaniyah
Zara	Zara
Zaria	Zaria
Zariah	Zariah
Zariyah	Zariyah
Zavier	Zavier
Zayden	Zayden
Zayne	Zayne
Zechariah	Zach, Zeke
Zeke	Zeke
Zion	Zion
Zoe	Zoe
Zoey	Zoey
Zoie	Zoie
Zuri	Zuri
